{
    "s_spin_well": {
        "rows": [
            "####..####",
            "###...####",
            "###.######",
            "###..#####",
            "####.#####"
        ]
    },
    "l_spin_well": {
        "rows": [
            "#######..#",
            "#######..#",
            "#######..#",
            "######...#",
            "######.###",
            "######.###",
            "######..##",
            "##########",
            "##########"
        ]
    },
    "t_spin_overhang": {
        "rows": [
            "#...######",
            "##...#####",
            "###.######",
            "###.######",
            "###.######"
        ]
    },
    "t_spin_well": {
        "rows": [
            "#..#######",
            "#..#######",
            "#...######",
            "###.######",
            "##..######",
            "#...######",
            "#.########",
            "#..#######",
            "#.########",
            "##########",
            "##########"
        ]
    }
}